PPPPPPPPPPPPPPP
0;;;;;;;;;;;;;;
0;;;;;;;;;;;;;;
0;;;;;;;;;;;;;;
0;;;;;;;;;;;;;;
0;;;;;;;;;;;;;;
0;;;;;;;;;;;;;;
0;;;;;;;;;;;;;;
0;;;;;;;;;;;;;;
0;;;;;;;;;;;;;;
0;;;;;;;;;;;;;;
0PPPPPPPPPPPPPP
0;;;;;;;;;;;;;;
0;;;;;;;;;;;;;;
0;;;;;;;;;;;;;;
0;;;;;;;;;;;;;;
0;;;;;;;;;;;;;;
0;;;;;;;;;;;;;;
0;;;;;;;;;;;;;;
0;;;;;;;;;;;;;;
0;;;;;;;;;;;;;;
0;;;;;;;;;;;;;;
0;;;;;;;;;;;;;;
0;;;;;;;;;;;;;;
0;;;;;;;;;;;;;;
0;;;;;;;;;;;;;;
0;;;;;;;;;;;;;;
